WWWWWWWWWWWWWWWW
WFFFFFFWFFFFFFFW
WFFFFFFFFFFFFFFW
WFFFFFFFFFFFFFFW
WFFFFFFFFFFFFFFW
WFFFFFFWFFFFFFFW
WFFFFFFWFFFFFFFW
WWWFFFWWWWWWFFFW
WFFFFFFFFFFWFFFW
WFFFFFFFFFFWFFFW
WFFFFFFFFFFWFFFW
WFFFFFFFFFFWFFFW
WFFFFFFFFFFFFFFW
WFFFFFFFFFFFFFFW
WFFFFFFFFFFFFFFW
WWWWWWWWWWWWWWWW
