{TTTTTTTT}
LFFFFFFFFR
LFFFFFFFFR
LFFFFFFFFR
LFFFFFFFFR
LFFFFFF<>R
LFFFFFF,.R
[BBBBBBBB]
